C:\ariadne\website 12\/map_csv/tbl/test  7-14-2014 11-44.csv
rood,groen,blauw,japan,turkije,usa,,,
218,0,0,78,76,64,0,0,
0,264,0,110,87,67,0,0,
0,0,306,88,99,119,0,0,
78,76,64,276,0,0,0,0,
110,87,67,0,262,0,0,0,
88,99,119,0,0,250,0,0,
0,0,0,0,0,0,0,0,
0,0,0,0,0,0,0,0,
