C:\ariadne\website 12\/map_csv/tbl/test  7-14-2014 11-47.csv
rood,groen,blauw,japan,turkije,usa,man,vrouw,
218,0,0,78,76,64,98,120,
0,264,0,110,87,67,99,165,
0,0,306,88,99,119,131,175,
78,76,64,276,0,0,133,143,
110,87,67,0,262,0,108,154,
88,99,119,0,0,250,87,163,
98,120,0,133,108,87,328,0,
99,165,0,143,154,163,0,460,
